SXXXXXXXXXXXXXXXXXXX
   B   B   B   B   X
XXXXXXXXXXXXXXXXXXXX
X  B   B   B   B   B
XXXXXXXXXXXXXXXXXXXX
  B   B   B   B   BX
EXXXXXXXXXXXXXXXXXXX
  B   B   B   B   B 